NO textures/N-letter.xpm
SO textures/S-letter.xpm
EA textures/E-letter.xpm
WE textures/W-letter.xpm

F 220,100,0
C 225,30,0

111111111111111111111111111111111111111111111111111111111111
1N0000000011111000000000001111000000000000000001111111111111
101111110011111011111111101111111111111111110001111111111111
100000010000001010000000000000000000000000010001000000000001
111110011111101011111111101111111111111101111111111111111101
100010000001001000000001001000000000001001000000000000000001
101111111101111111111101111111111101111011111111111111111101
101000000101000000000101000000001001000000000000000000000001
101011111101111101111101011111101011111101111111111111101111
100000000001000001000001000000001000001000000000000001000001
111111111111011111011111111111101111101111101111101011111101
100000000000010000000000000000000001000000000001001000000001
101111111111111111111111111111111111111111111111101111111101
100000000000000000000000000000000000000000000000000000000001
111110111111101111111111111111111111111111111111111111111101
100010000000101000000000000000000000000000000000000000000001
101011111111101111111111111111111111101111111111111111111111
101000000001000000000000000000000001000000000000000000000001
101111111101111111111111111111111101111111111111111111111101
100000000000000000000000000000000000000000000000000000000001
111111111111111111111111111111111111111111111111111111111111
