NO ./textures/E-letter.xpm
SO ./textures/E-letter.xpm
EA ./textures/E-letter.xpm
WE ./textures/E-letter.xpm
F 255,255,255
C 0,0,0
1111 1111 1111 1
10W111000 1000011
 11111111 1111
