NO ./textures/E-letter.xpm
SO ./textures/E-letter.xpm
EA ./textures/E-letter.xpm
WE ./textures/E-letter.xpm
C 255,255,255
F 0,0,0
  1111
 100001
100100W1
10001001
 100001
  1111