NO ./textures/E-letter.xpm
SO ./textures/E-letter.xpm
EA ./textures/E-letter.xpm
WE ./textures/E-letter.xpm
F 255,255,255
C 0,0,0



s


1111
10W1
1111



