NO textures/N-letter.xpm
SO textures/S-letter.xpm
EA textures/E-letter.xpm
WE textures/W-letter.xpm

F 220,100,0
C 225,30,0

11110111
10000001
10110N01
10010001
111 1111
