NO textures/N-letter.xpm
F 255,255,255
SO textures/S-letter.xpm
C 0,0,0
EA textures/E-letter.xpm
WE textures/W-letter.xpm
1111
1NE1
1111
